without - без - 
train - тренировка - 
small - маленький - 
quantity - количество - 
pronunciation - произношение - 
police - полиция - 
pass - здать (тест) - 
ok - окей - 
multiplication - умножение - 
manner - манера - 
last for about - (это будет) длится около - 
guess - угадать - 
give - давать - 
generation - поколение - 
disagree - не согласен - 
daughter - дочка - 
catch - поймать - 
cat - кот - 
at the end of the meeting - в конце встречи - 
at the beginning of the year - в конце этого года - 
apartment - квартира - 
again - еще раз - 
abroad - за границу - 
a Bit - немного - 
Zoo - зоопарк - 
Zip it - закрой рот - 
Younger - младше - дом
Young - молодой - 
You don't say - не может быть - 
Yesterday - вчера - 
Year - год - 
Yard - двор - 
Wrong - не прав - 
Write it down - записывать что то - фраза
Worse - хуже - 
Worry - беспокоить - 
Wonderful - прекрасно - 
Without - без - 
Wish - желаю - 
Wise - мудрый - 
Winter - Зима - время
Windy - ветреный - 
Will it last for - это будет длиться ? - 
Will Get tired - скоро устанешь - 
Wife - жена - 
Width - ширина - 
Why - почему - 
Whose - чей, чья - 
Who - кто - 
Where - где - 
When - когда - 
Wheel - колесо - 
What time - в какое время - 
What kind of - какого рода - 
What - что - 
Week - неделя - 
Wednesday - среда - 
We you they - are - 
Watch your mouth - следи за словами - 
Waste of time - потеря времени - фраза
Warm - тепло - 
Walk by - идти мимо - 
Walk - гулять - 
Wait - жди - 
Usually - обычно - 
Useless - бесполезный - 
Useful - полезный - 
Unusual - необычно - 
Until - до (завтра) - 
Unknown - неизвестно - 
Under - под (рубашка под штанами) - 
Uncle - дядя - 
Tuesday - вторник - 
Truth - правда - 
Trust - доверяю - 
Trousers - брюки - 
Trip - поездка - 
Travel - путешествовать - дом
Translate - перевод - 
Tonight - сегодня вечером - 
Tomorrow - завтра - 
Together - вместе - 
Today - сегодня - 
To be - быть - 
Tired - устал - 
Thursday - четверг - 
Threat - угроза - 
Third - третье - 
Think it over - обдумать это - 
Thing - вещь - 
Thin - тощий - 
There - там - 
Then - тогда (почему) - 
The worst - самый худший - общие
The only right - единственно верное - 
The most interesting - самый интересный - 
The end - конец - 
The day after tomorrow - послезавтра - 
The Costs - издержки, расходы - 
That - что - 
Tell - сказать (ей) - 
Tasty - вкусно - дом
Tall - высокий - 
Talk - разговаривать - общие
Take part - принимать участие - 
Take on - одеть (шапку) - 
Take off - снять (одежду) - 
Table - стол - дом
Swim - плавать - дом
Surprising - удивительно - 
Sure - конечно - 
Sunday - воскресенье - 
Summer - лето - время
Suit - костюм - 
Success - успех - 
Subject - предмет - 
Stupid - глупый - 
Spring - весна - время
Spend - проводят - 
Speak - говорить - 
Sooner or later - рано или поздно - 
Son - сын - 
Someone - кто то - 
Somehow - как то - 
Somebody - кто нибудь - 
Some - некоторый - 
Solution to - решение - 
Small - мало - 
Slowly - медленно - 
Slim - стройный - 
Sleep on it - обдумать еще раз - 
Skirt - юбка - 
Single - один - 
Simplicity - простота - 
Simple - простой - 
Sign - подписать - 
Should - следует - 
Short - короткий - 
Shirt - рубашка - 
Share - разделять - 
September - вересень - 
Separately - раздельно - дом
Sentence - речення - 
Sell - продавать - 
See you tomorrow - увидимся завтра - 
Second - секунда - 
Saturday - суббота - 
Satisfied with - удовлетворён с - 
Sales - продажи - 
Salary - зарплата - офис
Sad - грустный - 
Run away - убегай - 
Rude - грубый - 
River - река - 
Right now - прямо сейчас - 
Right - прав - 
Rich - богатый - 
Rest - отдыхать - 
Report - отчет - 
Reply - ответ - общие
Repair - исправить - 
Remember - помнить - 
Reinvent - переизобритать - 
Regret - сожалеть - 
Refuse - отказываться - 
React - реагировать - 
Range - диапазон - 
Rains - дощ - 
Quickly - быстро - 
Quantity - количество - 
Punish - наказывать - 
Pronunciation - произношение - 
Promise - обещать - 
Present day - сегодня - 
Present - присутствует - 
Prepare for - подготовиться к - 
Prepare (for) - подготовиться - офис
Prepare - подготовится - 
Prefers - предпочитает - 
Powerful - мощный - 
Potential - потенциальный - 
Possible - возможно - 
Poor - бедный - 
Polite - вежливый - офис
Point of view - точка зрения - 
Point at - указать на - 
Pocket - карман - 
Pleasure - удовольствие - 
Play - играть - 
Piss me off - вывести из себя - 
Picture - картина, рисунок - дом
Phrase - фраза - фраза
Perfectly realize - прекрасно осознавать - фраза
Passion - страсть - 
Party - вечеринка - 
Participate - принимать участие - 
Pair - пара - 
Own - собственная - 
Other - других(множина) - 
Order - приказывать - 
Opinion - мнение - 
Only - только (он) - 
One more time/ again - еще раз - 
One more time - еще раз - 
On time - вовремя - фраза
On holiday - в отпуске - 
On a business trip - в командировке - 
On Wednesdays - по средам - 
On Tuesday - во вторник - 
On Time - вовремя - 
On Holiday - отпуск - 
October - жовтень - 
Obviously - очевидно - 
Nowadays - настоящее время - время
November - листопад - 
Notice - заметят - 
Nobody - ніхто - 
No Biggie - не страшно - 
Necessary - необходимо - 
Near - близко - 
Native speaker - носитель языка - 
Must - должен - 
Multiply - умножение - 
Multiplication - умножение - 
Much (a lot) - много - 
Much - много - 
Morning - утро - 
More than enough - больше чем достаточно - 
Month - месяц - 
Monday - понедельник - 
Mix up - перемешать - 
Miss - соскучиться (за кем - 
Might - возможно - 
Mention - упоминать - 
Memory - память - 
Meat - мясо - 
Measure - меры - 
Meaning - значение - 
Mean - означает (глагол) - 
May - травень - 
Match more - намного больше - 
Married - женат - 
Marriage - свадьба - 
March - березень - 
Manner - манера - 
Main - главный - 
Mad - сумасшедший - дом
Lucky - везучий - 
Low blow - удар ниже пояса - 
Low - низкий - 
Loud - громко - 
Long - длинный - 
Little - мало - 
Listen to - слышать кого - 
Light - светло, свет - 
Library - библиотека - офис
Length - довжина - 
Lend - давать в долг - 
Leave - уходить - 
Lead to - приводит к - 
Lazy - ленивые - 
Laugh at - смеются над - дом
Late/ early - поздно/ рано - 
Late - поздно - 
Land - дать в долг - 
Kitchen - кухня - 
Kind - Добрый - 
Keen on - увлекатся - фраза
June - червень - 
July - липень - 
Joke - шутка - дом
January - січень - 
Invent - изобретать - 
Interrupt - перебивать - 
Intermediate - средний - 
Inspired - вдохновлять - 
Insist on - настаивать - 
Inform - информировать - 
Influence - влиять - 
Ineffective - неэффективно - 
Inconvenient - неудобно - офис
Include - включает (еда) - 
In the beginning - в начале - 
In The end - в конце - 
In August - в августе - 
Improve - улучшить - 
Impress - впечатлять - 
Impossible - невозможно - 
Important - важный - 
Impolite - невежливый - офис
Illness - болезнь - дом
I'm interested in it - я заинтересован в этом - 
I'll - болен - дом
I busy next week - занят на следующей неделе - 
I - am - 
Husband - муж - 
Hurry up - торопиться - 
How often - как часто - 
How much - общее - 
How many - конкретно - 
How - как - 
Hour - час - 
Hot - жарко - 
Holy crap - чёрт возьми - 
High - высокий - 
Here - здесь - 
Health - здоровье - 
He she it - is - 
Have read - прочитать - 
Have - иметь - 
Hard working - трудолюбивый - 
Hard - усердно - 
Guess - отгадать - 
Grown Up - взрослый - дом
Green - зелёный - 
Greatly - очень сильно - 
Great - огромное (удовольствие) - 
Grateful - благодарным - 
Go to bed - ложиться спать - 
Go shopping - ходить за покупками - дом
Go out - идти на выход, выходить - 
Go Shopping - ходить за покупками - 
Glad - рада (видеть) - 
Give - давать - 
Get up - вставать - 
Get dark - темнеет - 
Get - добираться - 
Generation - поколение - 
Furniture - мебель - дом
Funny - забавно - 
Full of - полон чего - 
Full Of - полон - 
Frighten - пугает - дом
Friendly - дружелюбный - дом
Friday - пятница - 
Free - (быть) свободным - 
Fourth' - четвёртое - 
Fourth - четвёртое - время
Forgive - простить - 
Forget - забывать - 
Forever - вечно - 
Foreign - иностранный - 
For years - годами - 
Fond of - обожаю - 
Follow - следуй, иди за мной - 
Fluently - свободно - 
Floor - пол - дом
Flat, apartment - квартира - 
Flat - квартира - 
First - первое - 
Finish it - закончить это - 
Finish - закончить - 
Financial - финансовый - 
Final - финальное - общее
Feeling - чувство - 
February - лютий - 
Fat - толстый - дом
Fast - быстро - 
Far - Далеко - 
Famous - известный - 
Family - семья - 
False - не правда - 
Fair - ярмарок - 
Eyes - глаза - 
Expression - выражение - 
Express - выразят, выскажут - 
Explanation - объяснения - офис
Explain - объяснить - 
Experience - опыт - офис
Expensive - дорогой - 
Exercise (exercise) - упражнение - 
Exercise - упражнение - 
Except for - кроме (огурцов) - 
Excellent - отлично - 
Everyone - все(he, she) - 
Everybody - все - 
Event - событие - 
Evening - вечер - 
Even - даже (он) - 
Equal - одинаковые - 
Enjoy - наслаждаться(сильно нравиться) - 
Elementary - элементарный - 
Elder - старше - дом
Educated - образованный - 
Easy - легко - 
Early - рано - 
Earlier - ранее - 
Each other - друг друга - фраза
During - на протяжении (моего сна) - 
Dream - мечта - дом
Don't freak out - не паникуй - 
Do the shopping - делать покупки - дом
Do The Shopping - делать покупки - 
Divorced - разведен - 
Division - ділення - 
Disease - болезнь - дом
Disappointed - расстроенные - 
Disagree - не соглашаться - 
Dirty - грязная - 
Difficult - тяжелый - 
Different - другой, разные - 
Dictionary - словарь - 
Devote to - уделять - 
Desk - письменный стол - офис
Depends - зависит - 
Deny - отрицать - 
Delicious - очень вкусно - дом
Decision - решение - 
December - грудень - 
Decade - 10 летие - 
Data - данные - офис
Dark - темно - 
Dangerous - опасно - 
Current - текущий (курс) - 
Currency - валюта - 
Cry - плакать, слёзы - 
Criticize - критикует - офис
Criminal - преступник - 
Crazy - сумасшедший - дом
Cost - стоить (глагол) - 
Correctly (rightly) - правильно - 
Correctly - правильно - 
Correct - правильный - 
Cook - готовить еду - 
Convenient - подходящий - общие
Control - контролирую - офис
Continue - продолжать - 
Confuse - перепутать - 
Condition - условия - офис
Complain - жалуется - 
Competition - соревнование - 
Compete - соревноваться - офис
Compare - сравнить - 
Community - сообщество - офис
Communicate - общаться - 
Commercial - коммерческий - 
Comfortable - удобное - дом
Color - цвет - дом
Cold - холодно - 
Coast - стоит (много) - дом
Clothes - одежда - 
Close - закрыть - 
Clever - умный - 
Clear - ясно понятно - общее
Choice - выбор - офис
Check - проверить - 
Cheap - дешевый - 
Chair - стул - дом
Certainly - конечно - 
Certain - уверен - 
Century - 100 летие - 
Celebrate - праздновать - дом
Catch - поймать - 
Can - могу - 
Calculate - рассчитать - 
By tomorrow - до завтра - фраза
Buy - покупать - 
But - но - 
Busy - занят - 
Brilliant - блестящий - 
Brave - смелая - 
Borrow - брать в долг - 
Birthday - день рождения - 
Birth - рождение - 
Bird - птица - 
Between - между - 
Better - лучше - 
Belong - принадлежать - 
Behind - позади - 
Behaviour - поведение - дом
Behave - ведёт себя - 
Beginner - новичок - 
Before - перед - время
Beer - пиво - 
Become - стать кем - 
Because of - из за (твоей собаки) - 
Bear - медведь - 
Bathroom - ванная - 
Bad - плохо - 
Available - доступен - 
Autumn - Осень - время
Authorities - власти - 
Aunt - тетка - 
August - серпень - 
Attractive - привлекательный - 
Attitude to - отношение - 
Attack - атаковать - 
Assistant - ассистент - 
As soon as possible - как можно быстрее - 
As - в то время когда (я ем _ я гуляю) - 
Article - статья - 
Armchair - кресло - дом
Area - область, район - общее
April - квітень - 
Approach - подход - 
Append - добавить - 
Apologize - извиняться - 
Any more - некогда больше - 
Any longer - не дольше - 
Answer - ответ - 
Another - другой, другая - 
Angry - злой - 
An Important - не важно - 
Among - серед - 
Alone - (живёт) сама - дом
Age - возраст - 
Against - против - 
Afternoon - днем - 
After - после - 
Afraid of - боятся (страшно) - 
Advertising - реклама - офис
Advertisement - рекламное объявление - офис
Advanced - продвинутый - 
Adult - взрослый - дом
Admire - восхищаешься - 
Adapt - адаптация - 
Achieve this aim - достигнуть этой цели - 
Absence - отсутствие - 
About - (говорить) про - 
A lot - много - 
